-1 -1 -1 -1 -1 -1 -1 -1 -1 -1 
-1 -1 -1 -1 -1 -1 -1 -1 -1 -1 
-1 -1 -1 -1 -1 -1 134 127 120 -1 
-1 -1 -1 -1 -1 -1 -1 -1 -1 -1 
-1 -1 134 127 120 -1 -1 -1 -1 -1 
-1 -1 -1 -1 -1 -1 -1 -1 -1 -1 
-1 -1 -1 -1 -1 -1 -1 136 -1 -1 
-1 -1 -1 -1 -1 -1 -1 -1 -1 -1 
-1 -1 -1 146 124 -1 -1 -1 -1 -1 
-1 76 71 71 71 69 79 78 77 -1 
76 75 85 85 85 69 -1 -1 -1 -1 
75 85 85 85 85 69 79 78 77 -1 
85 85 85 85 85 69 -1 -1 -1 -1 